Voici les numéros correspondant au blocks :
0: air, 1: pierre, 2: sable, 3: bouteille, 4: caisse, 5: clé,
6: coffre, 7: palmier, 8: roche, 9: pont, 10: tonneau, 11: pirate.

En dessous de cette ligne, se trouve la grille du niveau actuellement défini,
ainsi que le nombre de lignes possible en dessous.

########
0, 0, 0, 0, 0, 0, 0, 0, 0, 0, 0, 0, 0, 0, 0, 0, 0, 0
0, 0, 0, 0, 0, 0, 0, 0, 0, 0, 0, 0, 0, 0, 0, 0, 0, 0
0, 0, 0, 0, 0, 0, 0, 0, 0, 0, 0, 0, 0, 0, 0, 0, 0, 0
0, 0, 0, 0, 0, 0, 0, 0, 0, 0, 0, 0, 0, 0, 0, 0, 0, 0
0, 0, 0, 0, 0, 6, 0, 0, 0, 0, 0, 0, 0, 0, 0, 0, 0, 0
0, 11, 0, 5, 0, 2, 0, 0, 0, 0, 0, 0, 0, 0, 0, 0, 0, 0
2, 2, 2, 2, 2, 2, 2, 2, 2, 2, 2, 2, 2, 2, 2, 2, 2, 2

9
########

Un autre exemple de niveau :

0, 0, 0, 0, 0, 0, 0, 0, 0, 0, 0, 0, 0, 0, 0, 0, 0, 0
0, 0, 0, 0, 0, 0, 0, 0, 0, 0, 0, 0, 0, 0, 0, 0, 0, 0
0, 0, 0, 0, 0, 11, 0, 3, 0, 0, 0, 0, 0, 0, 0, 0, 0, 0
0, 0, 0, 0, 9, 1, 8, 8, 0, 0, 0, 0, 0, 0, 0, 0, 0, 0
0, 0, 0, 0, 0, 1, 0, 0, 0, 0, 0, 0, 0, 0, 0, 0, 0, 0
6, 0, 7, 4, 5, 1, 10, 0, 0, 0, 7, 0, 0, 0, 7, 0, 0, 0
2, 2, 2, 2, 2, 1, 1, 2, 2, 2, 2, 2, 2, 2, 2, 2, 2, 2

13